1111111111111111111111111111111111
1E00B000000000000000B00001000000B1
1C10010100100000101001000100010101
1P10010010101010001001000100010101
1000000000000000000000000001000001
1111111111111111111111111111111111