1111111111111111
1P1CB00000000001
1000000100000001
1000000E10000001
10C0000100000001
1111111111111111