11111111111111111111111111111111111111111111111111
10001000000000001000000000000000000000000000000001
10000000000000000100000000000000000000000000001001
1000000100000000000000000C000000010000000000000001
10000010000000000000000000000000000000000000000001
10000000000000000000000000001000000000000000000001
10000000000000110000000000000000000000000001000001
1000000000P000100000000000000000000000000000000001
10000000000000000000000000000001100000000000000001
1000000100000000000000000000000010C000000000000001
1011100000000100000000000000000000000E000000000001
1000C000000010000000000000000000000000001000000001
10000000000001000000001000000001000000000100C00001
10000000000000000000000000000000000000000000000001
11111111111111111111111111111111111111111111111111