111111111111111111111
100001000010011101011
100000000100000001001
100010110000011000101
100001000010001010001
100010110000011000111
100001000110111011111
1000PCE010100B0001111
100010000000010000111
111111111111111111111