11111111111111111111
100C1000010011101011
100000001E00000C1001
10010110000011000101
10001000010001010001
10010110000011000111
100010C0110111011111
100P00010100B0001111
10010000000010C00101
11111111111111111111