1111111111
100C100001
10000000E1
100P000101
1111111111